11111111111111111
10000000000000011
10P000000000E0011
10000000000000011
10000000000000011
10A00E00P00000011
10000000000000011
100C00000000C0011
1C000000000000110
1111111111111111111