11111111111111111
10000000000000011
10C000000000C0011
10000000000000011
10000000000000011
10C00E00P00000011
10000000000000011
100C00000000C0011
1C000000000000111
11111111111111111