NO textures/NO_XPM.xpm
SO textures/SO_XPM.xpm
WE textures/WE_XPM.xpm
EA textures/EA_XPM.xpm
F 220,100,0
C 255,30,0

        1111111111111111111111111   11111
        1000000000110000000000001   100W1
        1011000001110000000000001   11011
        1001000000000000000000001   11111
1111111110110000011100000000000011
100000000011000001110111111111111
11110111111111011100000010001
11110111111111011101010010001
11000000110101011100000010001
10000000000000000000000000001
10000000000000001101010010001
110000011101010111110111100011
11110111 1110101 101111010001
11111111 1111111 111111111111
