1111111111
1122131231
1231231231